####################
#........M........#
#.................#
#....####.........#
#.........P.......#
####################
